N A A A A A A A A A
N V V V V V V V V A
N N N N N N N N V A
V V V V V V V N V A
A A A A A A V N V A
A V V V V A V N V A
A V N N N N V N V A
A V N V V V V N V A
A V N N N N N N V A
A A A A A A A A A N