N,N,C,V,V,V,V,V,V,V
V,N,C,C,C,N,N,N,N,A
V,N,V,V,V,V,V,V,N,A
V,N,N,N,C,V,A,A,A,A
V,V,V,V,V,V,A,V,V,V
C,C,C,C,C,V,A,V,A,N
C,V,V,V,V,V,A,V,N,A
C,N,N,N,N,N,A,V,N,A
C,N,V,V,V,V,V,V,N,A
C,N,N,N,N,N,N,N,N,A